[top-level-domains]
lk=Sri Lanka
mk=Macedonia, Former Yugoslav Republic
ck=Cook Islands
dk=Denmark
museum=Museums
fk=Falkland Islands
cx=Christmas Island
sv=El Salvador
tv=Tuvalu
name=Individuals
lv=Latvia
ac.uk=Education (UK)
com=Commercial
cv=Cap Verde
pn=Pitcairn Island
td=Chad
int=Int. Organizations
id=Indonesia
md=Moldova, Republic of
iq=Iraq
mn=Mongolia
ad=Andorra
bd=Bangladesh
mq=Martinique
as=American Samoa
gd=Grenada
gq=Equatorial Guinea
ro=Romania
so=Somalia
to=Tonga
zm=Zambia
io=British Indian Ocean Territory
jo=Jordan
mo=Macau
no=Norway
sm=San Marino
pw=Palau
ao=Angola
bo=Bolivia
co=Colombia
do=Dominican Republic
fo=Faroe Islands
ve=Venezuela
ac=Ascension Island
sj=Svalbard and Jan Mayen Islands
tj=Tajikistan
mx=Mexico
aq=Antarctica
ae=United Arab Emirates
bj=Benin
dj=Djibouti
gov=Government (US)
fj=Fiji
org=Organization (non-profit)
ru=Russian Federation
asia=Asian Countries
vu=Vanuatu
hu=Hungary
pa=Panama
lu=Luxembourg
mu=Mauritius
nu=Niue
au=Australia
cu=Cuba
eu=European Countries
gu=Guam
mv=Maldives
sc=Seychelles
tc=Turks and Caicos Islands
vc=Saint Vincent and the Grenadines
bv=Bouvet Island
tp=East Timor
lc=Saint Lucia
mc=Monaco
nc=New Caledonia
jp=Japan
kp=Korea, Democratic People's Republic
mp=Northern Mariana Islands
np=Nepal
ec=Ecuador
lr=Liberia
gp=Guadeloupe
sn=Senegal
tn=Tunisia
aero=Air-transport industry
vn=Vietnam
hn=Honduras
in=India
tm=Turkmenistan
kn=Saint Kitts and Nevis
coop=Cooperatives
an=Netherlands Antilles
bn=Brunei Darussalam
cn=China
nr=Nauru
gn=Guinea
ar=Argentina
pf=French Polynesia
gm=Gambia
si=Slovenia
pe=Peru
ki=Kiribati
li=Liechtenstein
ni=Nicaragua
ai=Anguilla
bi=Burundi
ci=Cote d'Ivoire (Ivory Coast)
fi=Finland
gi=Gibraltar
sg=Singapore
tg=Togo
sd=Sudan
pt=Portugal
vi=Virgin Islands (USA)
st=Sao Tome and Principe
tt=Trinidad and Tobago
kg=Kyrgyzstan
mg=Madagascar
ht=Haiti
it=Italy
ag=Antigua and Barbuda
bg=Bulgaria
cg=Congo, Republic of
nt=Neutral Zone
eg=Egypt
cd=Congo, Democratic Republic of the
at=Austria
bt=Bhutan
et=Ethiopia
gt=Guatemala
sb=Solomon Islands
edu=Educational Institution
ne=Niger
lb=Lebanon
ms=Montserrat
bb=Barbados
sz=Swaziland
tz=Tanzania
uz=Uzbekistan
pm=St. Pierre and Miquelon
kz=Kazakhstan
mz=Mozambique
nz=New Zealand
um=US Minor Outlying Islands
hm=Heard and McDonald Islands
im=Isle of Man
jm=Jamaica
km=Comoros
mm=Myanmar
om=Oman
am=Armenia
bm=Bermuda
cm=Cameroon
dm=Dominica
travel=Travel related businesses
fm=Micronesia, Federal State of
az=Azerbaijan
bz=Belize
cz=Czech Republic
dz=Algeria
ph=Philippines
sh=St. Helena
th=Thailand
net=networks
pg=Papua New Guinea
kh=Cambodia
mh=Marshall Islands
ug=Uganda
vg=Virgin Islands (British)
bh=Bahrain
ch=Switzerland
eh=Western Sahara
tf=French Southern Territories
gh=Ghana
ng=Nigeria
mil=Military (US Dept of Defense)
cl=Chile
wf=Wallis and Futuna Islands
gg=Guernsey
ws=Western Samoa
nf=Norfolk Island
is=Iceland
af=Afghanistan
bf=Burkina Faso
cf=Central African Republic
info=Unrestricted use
gf=French Guiana
bs=Bahamas
cs=Czechoslovakia
es=Spain
pro=Accountants, lawyers, and physicians
gs=South Georgia and the South Sandwich Islands
qa=Qatar
sa=Saudi Arabia
ua=Ukraine
va=Holy See (City Vatican State)
biz=Businesses
la=Lao People's Democratic Republic
ma=Morocco
na=Namibia
ba=Bosnia Hercegovina
ca=Canada
ga=Gabon
cc=Cocos Islands (Keeling)
pl=Poland
sl=Sierra Leone
py=Paraguay
il=Israel
uy=Uruguay
ml=Mali
nl=Netherlands
yt=Mayotte
al=Albania
ly=Libyan Arab Jamahiriya
my=Malaysia
za=South Africa
gl=Greenland
by=Belarus (Byelorussia)
cy=Cyprus
co.uk=Commercial United Kingdom
yu=Yugoslavia
gy=Guyana
rw=Rwanda
tw=Taiwan
ky=Cayman Islands
lt=Lithuania
mt=Malta
sr=Suriname
tr=Turkey
kw=Kuwait
mw=Malawi
sy=Syrian Arab Republic
ye=Yemen
aw=Aruba
bw=Botswana
gw=Guinea-Bissau
re=Reunion Island
se=Sweden
pr=Puerto Rico
ie=Ireland
je=Jersey
ke=Kenya
hr=Croatia/Hrvatska
ir=Iran, Islamic Republic of
kr=Korea
be=Belgium
mr=Mauritani
de=Germany
ee=Estonia
ge=Georgia
br=Brazil
cr=Costa Rica
ps=Palestinian Territories
er=Eritrea
fr=France
gr=Greece
us=United States
ls=Lesotho
pk=Pakistan
zw=Zimbabwe
sk=Slovak Republic
tk=Tokelau
uk=United Kingdom
hk=Hong Kong